###################################
#   # ##                          #
# #    # ############## ######### #
# ###### #   # #      # ## ##   # #
#          # # ###### # #     # # #
###### # ### #      # # ## ##   # #
##   # # # # #### # #   ##### # # #
#  #   # #      # ## ###### #   # #
######## # ####         #   # # # #
#   #    #      ####### # # #   # #
# ### #### ######       # #   #   #
#          #      ####### #########
############ ######   # # #   #   #
#                   #   #   #   # #
###################################